---------------------------------------------------------------
---------------------------------------------------------------
---------------------------------------------------------------
---------------------------------------------------------------
---------------------------------------------------------------
--------------###########################################------
----------#####------#----------#------#--------#-------#------
---------------------#----------#------#--------#-------#------
---------------------#---------#-------#--------#-------#------
---------------------#---------#-------#--------#-------#------
---------------------#---------#-------#--------##------#------
---------------------#---------#-------#---------#------#------
---------------------#---------#-------#---------#------#------
---------------------#--------##-------#---------#------#------
---------------------#--------#--------#---------#------#------
---------------------##-------#--------#---------#------#------
----------------------#-------#--------#---------#------#------
----------------------#-------#--------#---------#------#------
----------------------#-------#--------#---------#------#------
----------------------#-------#--------#---------#------#------
----------------------#-------##-------#--------#-------#------
-----------------------#-------#-------#--------#-------#------
-----------------------#-------#-------#--------#-------#------
-----------------------#-------#-------#--------#-------#------
-----------------------#-------#------#---------#-------#------
-----------------------#------------------------#-------#------
-----------------------#---------------------------------#-----
------------------------#--------------------------------#-----
-------------------------#-------------------------------#-----
-------------------------##------------------------------#-----
--------------------------##-----------------------------#-----
---------------------------##----------------------------#-----
----------------------------##--------------------------##-----
--------------------------------------------------------#------
--------------------------------------------------------#------
--------------------------------------------------------#------
--------------------------------------------------------#------
--------------------------------------------------------#------
--------------------------------------------------------#------
--------------------------------------------------------#------
--------------------------------------------------------#------
