-----#--------------------------------------------------------------------------------------------------------------------------------------------------------------------------------------------------
--#--#--------------------------------------------------------------------------------------------------------------------------------------------------------------------------------------------------
--#--#-----------------------##-------------------------------------------------------------------------------------------------------------------------------------------------------------------------
--#------------###-------#-----#------------------------------------------------------------------------------------------------------------------------------------------------------------------------
------------####---------#-----##-----------------------------------------------------------------------------------------------------------------------------------------------------------------------
---------###-------------#------#-----------------------------------------------------------------------------------------------------------------------------------------------------------------------
-------###---------------#-----------------------------#------------------------------------------------------------------------------------------------------------------------------------------------
-----###----------------##-----------------------------###------------###----#--------------------------####--------------------------------------------------------------------------------------------
----##---------------####------------------------------#####-------####-------#-----------------------###--###------------------------------------------------------------------------#####-------------
--------------------------------------------------------##-------###-----------#---------------------##---------------------------------------------------------------------------####-----#------------
---------------###-----------#---------------------------##---------------------#--------------------#------------------------------------------------------#######--------------##--------#------------
--#-----------##-----------##----------------------------------------------------#------------------##-------------------------------------------------------------#-----------------------#------------
--#----------##----------###--------------------------------------------------------------------------------------------------------##-####------------------------##-----------#----------#------------
--#-------####----------##--------------------------------------------------------##--------------------------------------------####-------#------------------------#-----------#----------#------------
-----######---------#####-----------------------------------------------------------------------------------------------------##-----------#-------------------------#----------#----------#------------
--------------------------------------------##-------------------------------------#------------------------------------------#-------------#------------------------##---------#----------#------------
-------------------------------------------#-##-------------------------------------#------------------------------------------#------------##------------------------#---------#---------#-------------
-------------------------------------------#--##------------------------------------#-------------------------------------------##------------#------------------------#--------#---------#-------------
-------------------------------------------#---#-------------------------------------#-------------------------------------------##------------###---------------------#--------------------------------
-------------------------------------------#---#-------------------------#-----------#--------------------------------------------#------------------------------------##--------#--------#-------------
-------------------------------------------#---#------------------------##-----------#---------------------------------------------#------------------------------------#-------##--------#-------------
------------------------------------------##---#----------------##-----##-----------------------#----------------#-----------------#------------------------------------#-------#-----------------------
------------------------------------------#---##----------------#------#------------------------#----------------#------------------------------------------------------#------##-----------------------
---------------------------------------------------------------#-------#----------------------------------------#----------------------------------------------------###-------#------------------------
--------------------------------------------------------------#-------#---------------------------------------##--------------------------------------###-#-#-#-#####----------#------------------------
--------------------------------------------------------------#------#----------------------------------------#---------------------#--------------#----------------------------------------------------
-------------------------------------------------------------#---------------------------------------------------------------------##-------------#-----------------------------------------------------
------------------------------------------------------------##---------------------------------------------------------------------#-------------#------------------------------------------------------
--------------------------#####-----------------------------#---------------------------------------------------------------------#-------------#-------------------------------------------------------
------------------------###----#----------------------------#-------------------------#-------------#------------------------------------------##--------------------------#----------------------------
----------------------###-------------------------------------------------------------#----------###------------------------------------------##---------------------------#----------------------------
---------------------##---------------------------------------------------------------#-------------------------------------------------------#----------------------------#--------------#-------------
-------------------##-----------------------------------------------------------------#------#--------------------------#--------------------------------------------------##-------------#-------------
-----------------##-------------------------------------------------------------------#------#-------------------------#----------------------------------------------------##------------##------------
----------------##--------------------#----------------------------------------------#-------#------------------------#---------------------------------------#--#-----------#----------------------#---
---------------##--------------------#----------------------------------------------##-------#-----------------------#------------------------#--------------#----#----------##-------------------##----
--------------##--------------------##-----------------------------------------#-------------#-----------------------#------------------------#-------------##-----#----------#------------------##-----
-------------##---------------------#-------------------------------------###-#--------------#------------------------------------------------##------------#------#----------#-------------------------
-------------#---------------------#-----------------------------------###-------------------#-------#-----------------#-----------------------#-----------#--------#-----------------------------------
-------------#-------------------##----------------------------------###---------------------#------##-----------------##----------------------#-----------#--------#-----------------------------------
-------------#-----------------###------------------##---------------#-----------------------#-----##---#---------------#--------------------##---------------------#-----------------------------------
-------------#----------------##-------------------##----------------#----------------------#------#----#---------------##----------------###-----------------------#-----------------------------------
-------------#--------------##--------------------##------------------#---------------------#------#-----#---------------#------------####--------------------------#-----------------------------------
-------------#-------------##--------------------##---------#---------##--------------------#------------#---------------##-------##-#------------------------------------------------#-----------------
-------------#-------------#--------------------#----------##----------#---------------------------------#----------------#-------##-------------------------------------------------##-----------------
-------------#-------------#------------------##-----------#---------------------------------------------#---------------#---------#------------------------------------------------##------------------
-------------#------------#-------------------#------------#---------------------------------------------#---------------#----------------------------------------------------------#-------------------
-------------#------------#-----------------##-------------#--------------------#-########---------------#--------------##------------------------------#-----------------------------------------------
-------------#------------#-----------------#---------------#-------------------#---------------------------------------#-------------------------------#-------------#---------------------------------
-------------#------------#---------------------------------#-------------------#---------------------------------------#-------------------------------#-------------#---------------------------------
-------------#------------#--------------------------------#--------------------#--------------------------------------#--------------------------------##------------##--------------#-----------------
-------------#-----------##-----------------------------------------------------#-------------------------------------##---------------------------------#-------------#--------------##----------------
-------------------------#---------------#--------------------------------------#----------------------------------------------------------#-------------#--------------#--------------#----------------
----------------------------------------#--------------------------------#-------#----------------------------------------------------------#-------------##------------##-------------##---------------
----------------------------------------#--------------------------------#------------------------------#-----------------------------------#---------------####------------------------#---------------
---------------------------------------#---------------------------------#-----------------------------##------------------------------------#-------------------------------------------#--------------
---------------------------------------#------------------#--------------#-----------------------------#-------------------------------------##------------------------------------------##-------------
---------------------------------------#-----------------##--------------#--------------------#--------#--------------------------------------#-------------------------------------------#-------------
--------------------##----------------##-----------------#--------------#---------------------#-------#---------------------------------------#--------------------------------------------#------------
----------------#####-----------------------------------##-----------------------------------------------------------------------------------##--------------------------------------------##-----------
---------------##--------------------------------------##-------------#---------------------------##-----------------------------------------#----------------------------------------------#-----------
--------------##--------------------------------------#---------------#--------------------------#-------------##---------------------------------------------------------------------------------------
-------------##------------------------------------------------------#------------#-------------#-------------##----------------------------------------------------------------------------------------
------------##-----------------------#------------------------------##------------#-------------#------------##----------##-----------------------------------------------------------------------------
-----------##-----------------------#-------------------------------#-------------#-----------##------------#----------###-#----------------------------------------------------------------------------
-----------#------------------------#---------#--------------------##-------------#----------#--------------#----------#--------------------------------------------------------------------------------
----------#-------------------------#--------#---------------------#--------------#---------##-------------##---------------------------------------------------#---------##----------------------------
----------#------------------------#---------#-------------------------------------#--------#--------------#--------------------------------------------------##---------##-#---------------------------
----------#------------------------#---------#---------------------##--------------#-----------------------#-------------------------------------------------##---------##--------------#---------------
-----------------------------------#---------#----------------------#--------------#---------#-------------#----------------###-------##-------------------##----------##----------#----##--------------
----------------------------------#---------#-----------------------#------------------------##------------#------#---------------#####------------------###-----------#-----------#-----##-------------
--------#-------------------------#---------------------------------#------------#------------##-----------#------#---------------------------------------------------#------------#------#-------------
-------#-------------------------#----------------------------------#------------##------------##----------#------#--------------------------------------------------#-------------#--------------------
------##------------------------#-----------------------------------#-------------##------------#-----------#-----#-----------------------------###-----------------##-------------#--------------------
-----##-------------------------#-----------------------------------#---------------##-----------#----------#-----#--------------------------##--------------------##--------------#--------------------
-----#--------------------------------------------------------------#-----------------###--------#----------#-----#----------------------#-#-----------------------#---------------#--------------------
-----#-------------------------------------#------------------------#-----------------------------#----------#----#--------------------##-------------------------#----------------#--------------------
-----##-----------------------------------#------------------------------------------------------------------#-----------------------##--------------------------#-----------------#--------------------
------#----------------------------------##--------------------------------------------------------#----------#----------------------#--------------------------#------------------#--------------------
-------#--------------------------------##-------------------------------------------##-------------#---------##---------#-------------------------------------##---------------------------------------
--------#------------------------------#-------------------------------------------###-----------------------------------#---------------##-------------------#-----------------------------#-----------
---------#-------------##--------------------------------------------------------###----------------#--------------------#----------------#------------------#------------------------------#-----------
---------####--------##--------------------------------------------------------###-------------------#-------------------#----------------##-----------------#------------------------------##----------
----------------#####----------------#--------------------------#--------------#---------------------#------------------##-----------------#-----------------##------------------------------#----------
-------------------------------------#-------------------------#-------------------------------------#------------------#------------------#-------#----------#---------------------#---------#---------
-------------------------------------#---------------------------------------------------------------#-----------------#-------------------#-------##---------#--------------------#-----------#--------
-------------------------------------#------------------------#--------------------------------------------------------#-------------------#---------#--------##------------------##--------------------
-------------------------------------#-----------------------#--------------------------------------------------------#--------------------#---------##--------#-----------------##---------------#-----
------------------------------------------------------------##-------------------------------------------------------##-------------------#---------------------#--------------###-------------####-----
----------------------#-------------------------------------#----------------#------------------------------------------------------------#---------------------##------------------------#-##----------
---------------------##----------------------------------###-----------------#------------------------------------------------------------#----------------------###--------------------#---------------
--------------------------------------------#--------------------------------#---------------------------------#--------------------------#-------------------------------------------------------------
-------------------#------------------#-#-#----------------------------------#-----------------#---------------##------------------------#-------------------##-----------------------------------------
-------------------##--------------##----------------------------------------##--------------##------------------##-#-#------------------#--------------------###---------#-----------------------------
--------------------########----###--------------------------------------------##---####--------------------------------#-####---------##-----------------------##-------##-----------------------------
---------------------------------------------------------------------------------###------------------------------------------##---------------------------------##--#####------------------------------
--------------------------------------------------------------------------------------------------------------------------------------------------------------------------------------------------------
--------------------------------------------------------------------------------------------------------------------------------------------------------------------------------------------------------
--------------------------------------------------------------------------------------------------------------------------------------------------------------------------------------------------------
--------------------------------------------------------------------------------------------------------------------------------------------------------------------------------------------------------
