-------#-##----#------
##--#-----#--##--##---
#-------#--#--##-##---
--#---#---##-##---##--
-----#---#-----##-#---
-#-----##--###-#-----#
------#---####---#----
-#--##--#-#--#-#--#-##
#-#----#--#-----#--##-
--#---###-#----##----#
----#----#---#####-#--