---------------------------------------------------------------
---------------------------------------------------------------
---------------------------------------------------------------
---------------#-----------------------------------------------
-------------###-----------------------------------------------
-----------###-------------------------------------------------
---------##----------------------------------------------------
--------##-----------------------------------------------------
--------#------------------------------------------------------
-------##-------------------------------------------------#####
-------#-----#####################################--#######----
-------#-------------------------------------------------------
-------#-------------------------------------------------------
-------#------------#------------------------------------------
-------#-------------------------------------------------------
-------#---------------------------------------------#---------
------##------------------------------------------####---------
-----##-----------------------------------------###------------
-----#-------------------##--------------------##--------------
-----#------------------###-------------------#----------------
----#-----------------###-##-----------------#-----------------
----#----------------##----#---------------##------------------
----#--------------###-----#--------------##-------------------
---##------------###-------#-------------##--------------------
---#-----------##----------#------------#----------------------
---#---------###----------##----------##-----------------------
---#-------###---------####----------#---------------#---------
---#-------#--------####-----------##---------------#----------
---#------#--------#--------------##---------------##----------
---#-----##-------#-------------##----------------##-----------
---#----##-------##------------##----------------##------------
---#----#--------#------------------------------##-------------
---#-------------------------------------------##--------------
---#-----------------------------------------###---------------
---##---------------------------------------##-----------------
----##--------------############---------###-------------------
-----#--------------#-----------#########----------------------
-----###-------------------------------------------------------
---------------------------------------------------------------
---------------------------------------------------------------
---------------------------------------------------------------
